#####S######
###........#
####......##
####....E.#
####.....###
###....#####
###....#####
##....######
#.....######
############

